,ID,Needle,Needle_length,Needle_start,Needle_stop,Needle_plddt
0,TanAAp,YEWSAGQYADATDSRAEGVWTQPLS,24,252,276,97.50043478260868
1,TanALp,YEWNMGQYSNSGTRKQGTWTKALS,23,255,278,97.32545454545453
2,TanASl,YEWQMGQYGNEGNRKKNSFQKQLS,23,264,287,95.76272727272728
3,TanASg,YEWNMGSTRSDLSDEEQTIS,19,240,259,94.83222222222221
4,TanBFnp,YEWMYNGVNSYSRMEFTRNTSAQEYNDRSLTRSTVQGNLTEDEIKIS,46,225,271,89.5988888888889
5,TanBLpa,YEWQFNGINDWHRYQPVAGTAVNGRPKFEPVSGVLDSEAQALS,42,216,258,96.84341463414633
6,TanBLpe,YEWQFNGINDWNRSQPVAGSMKNGRPKFESITGTLSASDQSLS,42,216,258,96.43780487804875
7,TanBLp,YEWQFNGINDWHRYQPVAGTTKNGRPKFEPVSGQLTVEEQALS,42,216,258,97.4680487804878
8,TanBSg,YEWMFQAKKIYTFNSRVRPQIINKRQQLLS,29,206,235,96.09750000000001
9,TanBSs,YEWNWGTNTLATGKQVDQAVS,20,262,282,98.04105263157896
10,TanCb1,YEWNMGQYFTTDTRDSSSFKSALS,23,254,277,97.19954545454547
11,TanCb2,YEWQFCGYNDYHRIKHVRSESGVKNIQIDGILTEKQIKIS,39,228,267,92.66842105263159
12,641746432,YEWMYNGVNSYSRMEFTRNTSAQEYNDRSLTRSTVQGNLTEDEIKIS,46,225,271,89.138
13,647526067,YEWMYNGVNSYSRMEFTRNTSAQEYNDRSLTRSTVQGNLTNDEINIS,46,225,271,88.09866666666667
14,2505790797,YEWQLNKIHAFKFRGREGTLDAEALKVS,27,218,245,95.75769230769232
15,2509549983,YEWELGVARTNLSAETKEVS,19,221,240,92.52111111111111
16,2511056385,YEWMMGVTRSGLTDEQQAIS,19,377,396,94.74333333333334
17,2515271184,YEWQFNGVNNYAKRGGGGPAGGGMPQQATVASLTDDQIRVS,40,230,270,76.15230769230769
18,2520858584,YEWMYNGVNSYLRMEFTKNTSAQEYNDRSLTHSTVQGNLTDNEIKVS,46,224,270,90.57555555555555
19,2532577375,YEWMYNGVNSYLRMEFTKNTSAQEYNDRSLTHSTVQGNLTDNEIKVS,46,225,271,89.93444444444445
20,2554439104,YEWMYNGVNSYSRMEFTKNTSAQEYNDRSLTRSTVQGNLTDNEIKVS,46,225,271,88.55999999999999
21,2554441166,YEWMYNGVNSYSRMEFTRNTSAQEYNDRSLTHSTVQGNLTNDEINIS,46,225,271,89.30488888888891
22,2559352011,YEWQFNGVNEYSRMDMSRLNADSYNNRSKPMPKIEGSLSELEIRVS,45,233,278,88.0734090909091
23,2559386245,YEWQFNGVNEFSRIDMSKLNSAEFNDRSKPMPKIEGTLSEAEIKLS,45,233,278,89.53090909090908
24,2561336272,YEWMYNGVNSYSRMEFTKNTSAKEYNDRSLTHSTVQGNLTEDEIKIS,46,225,271,88.17955555555555
25,2561339177,YEWMYNGVNSYSRMEFTKNTSAQEYNDRSLTRSTVQGNLTEDEIKIS,46,225,271,88.33400000000002
26,2561341273,YEWMYNGVNSYSRMEFTKNTSAQEYNDRSLTRSTVQGNLTEDEIKIS,46,225,271,89.12466666666666
27,2564011747,YEWMYNGVNSYSRMDFTRNTSAQEYNDRSLTHSTVQGNLTNDEINIS,46,225,271,90.7202222222222
28,2567017550,YEWMYNGVNSYSRMEFTRNTSAQEYNDRSLTRSTVQGNLTEDEIKIS,46,225,271,88.48444444444446
29,2567022283,YEWMYNGVNSYSRMEFTKNTSAKEYNDRSLTHSTVQGNLTEDEIKIS,46,225,271,87.04755555555558
30,2567202592,YEWMYNGVNSYSRMEITRNTSAEEYNDRSLTRSTVQGNLTEDEIKIS,46,225,271,89.3388888888889
31,2567372575,YEWMYNGVNSYSRMVFSENTTAEEYNDRSLTHSTVQGNLTEDEIKIS,46,225,271,89.50800000000001
32,2567373568,YEWMYNGVNSYSRMEITRNTSAEEYNDRSLTRSTVQGNLTEDEIKTS,46,227,273,89.80822222222223
33,2567377351,YEWMYNGVNSYSRMVFSENTTAEEYNDRSLTHSTVQGNLTEDEIKIS,46,225,271,90.50022222222219
34,2635528200,YEWMYNGVNSYSRMEFTRNTSAQEYNDRSLTRSTVQGNLTNDEINIS,46,225,271,88.03555555555556
35,2678400947,YEWMYNGVNSYSRMEFTRNTSAQEYNDRSLTRSTVQGNLTNDEINIS,46,225,271,89.09000000000002
36,2705769279,YEWELGVARTGLDSETKAVS,19,222,241,92.75833333333335
37,2765624323,YEWMYNGVNSYSRMEFTRNTSAQEYNDRSLTHSTVQGNLTNDEINIS,46,225,271,90.042
38,2813373532,YEWQFNGVNDYEKIDISMLDYRVERKTVRGTQTAEQQRLS,39,224,263,87.82289473684212
39,2813878675,YEWQFNGYNDYKKMDISMLDYHIQRKETKGTLTNDQQVVS,39,216,255,87.7273684210526
40,2843925074,YEWMYNGVNSYLRMEFTKNTSEQEYNDRSLTHSTVQGNLTDNEIKVS,46,225,271,90.4428888888889
41,2847470013,YEWMYNGVDSYSRMEFTRNTSAQEYNDRSLTRSTVQGNLTEDEIKIS,46,225,271,89.39244444444444
42,2849014119,YEWMYNGVNSYSRMEFTRNTSAQEYNDRSLTRSTVQGNLTNDEINIS,46,225,271,90.22422222222221
43,2856181804,YEWMYNDVNSYSRMEFTRNTSAQEYNDRSLTHSIVQGNLTDEEIKIS,46,224,270,91.15288888888887
44,2856190891,YEWMYNGVNSYSRMEFTKNTSAQEYNDRSLTRSTVQGNLTEDEIKIS,46,225,271,89.63066666666668
45,2859119394,YEWMYNGVNSYSRMEFTRNTSAQEYNDRSLTRSTVQGNLTEDEIKIS,46,225,271,89.75866666666668
46,2859120770,YEWMYNGVNSYSRMEFTRNTSAQEYNDRSLTRSTVQGNLTEDEIKIS,46,225,271,89.80977777777777
47,2859127800,YEWMYNGVNSYSRMEFTKNTSAQEYNDRSLTRSTVQGNLTEDEIKIS,46,225,271,89.20888888888886
48,2859139131,YEWMYNGVNSYSRMEFTKNTSAQEYNDRSLTRSTVQGNLTEDEIKIS,46,225,271,90.30600000000003
49,2869309611,YEWMYNGVNSYSRMGFTKNTSAKEYNDRSLTHSTVQGNLTEDEIKIS,46,225,271,89.97800000000001
50,637258864,YEWMYNGVNSYSRMEFTRNTSAQEYNDRSLTRSTVQGNLTNDEINIS,46,219,265,87.16666666666667
51,646254125,YEWMYNGVNSYSRMEFTRNTSAQEYNDRSLTRSIVQGNLTDEEIKIS,46,229,275,89.1046666666667
52,646256224,YEWMYNGVNSYLRMEFTKNTSAQEYNDRSLTHSTVQGNLTDNEIKVS,46,229,275,90.0551111111111
53,644252663,YEWSAGQYADGDTRASGTWTHALS,23,254,277,97.18409090909091
54,648818377,YEWNMGSTRSDLSDEEQTIS,19,240,259,95.85611111111108
55,651076336,YEWNMGSTRSDLSDEEQTIS,19,240,259,95.59
56,2515594305,YEWNWGGNKLNSGARVDQSVS,20,259,279,97.95736842105262
57,2518419131,YEWNMGQYSNSGTRKQGTWTKALS,23,255,278,96.3368181818182
58,2518695199,YEWNMGQYSTSGTRASGTFTKALS,23,255,278,95.94227272727272
59,2518712047,YEWNMGQYSTSGTRASGTFTKALS,23,255,278,97.13909090909091
60,2521682749,YEWNWGGNALSTGKQVDQTVS,20,263,283,98.15947368421051
61,2521772704,YEWNWGTNALGTGKQVAQAVS,20,257,277,96.90578947368422
62,2525441047,YEWMMGTTRSGLTDEEQSIS,19,254,273,95.92388888888888
63,2525509443,YEWMMGTTRSGLTEEEQSIS,19,254,273,94.59722222222223
64,2525512195,YEWMMGTTRSGLTDEEQSIS,19,254,273,94.54944444444443
65,2526247906,YEWMMGTTRSGLTDEEQSIS,19,254,273,94.48944444444444
66,2541461213,YEWSAGQYVTSDSRAEGLWTKALS,23,253,276,96.29636363636364
67,2541814430,YEWMMGQFSDEGARAEGSFGGALS,23,265,288,95.10772727272729
68,2545784013,YEWMMGTTRSDLTQEEQSIS,19,249,268,94.48944444444444
69,2549870083,YEWQFSGIYTYKKLQMPANTDFNAERVWVEGTLTEDQIRVS,40,221,261,84.01871794871792
70,2553000633,YEWQMGQYTNSNSRKNKTFQKELS,23,264,287,96.77318181818183
71,2559783787,YEWMMGQFASTDTRADGTWTKLLS,23,255,278,97.63272727272728
72,2561325321,YEWSAGQYADATDSRAEGVWTQPLS,24,252,276,97.47217391304345
73,2561327489,YEWSAGQYADATDSRAEGVWTQPLS,24,252,276,96.49782608695651
74,2561459174,YEWNMGNTRTDLTDEEQEIS,19,243,262,96.32555555555558
75,2562201711,YEWQMGNTRTGLSEEEQKIS,19,252,271,92.01944444444445
76,2562551738,YEWMMGTTRSGLTDEEQSIS,19,259,278,94.6472222222222
77,2563232424,YEWNMGQYSTSGTRASGTFTKALS,23,255,278,96.53636363636365
78,2571114083,YEWMMGTTRSDLTDEEQSVS,19,248,267,95.3727777777778
79,2582171838,YEWNMGQYSNSGTRKQGTWTKALS,23,255,278,95.02545454545454
80,2585308755,YEWNWGTNALSTGKQVDQTVS,20,261,281,98.13736842105263
81,2586993216,YEWNMGQYSNSGTRKQGTWTKALS,23,255,278,95.83454545454546
82,2598962618,YEWNMGQYSNSGTRKQGTWTKALS,23,255,278,95.75772727272728
83,2599311692,YEWNMGSTRSDLSDEEQTIS,19,240,259,95.90333333333335
84,2600401283,YEWQMGQYTNSNSRKNKTFQKALS,23,264,287,97.25136363636362
85,2601013064,YEWSAGQYADATDSRAEGVWTQPLS,24,252,276,97.40739130434778
86,2608461850,YEWMMGQFSTAGNRADGTWTASLS,23,255,278,95.4309090909091
87,2609146504,YEWMMGQFSSDGTRADGTWTKMLS,23,251,274,97.77227272727274
88,2624521198,YEWMFNGINDYEGRTTKGTLTKEQTEIS,27,222,249,96.7173076923077
89,2629350457,YEWNMGQYSNSDTRANDTWTSALS,23,258,281,96.63136363636363
90,2630154569,YEWNMGQYANSGTRKPGTWTKALS,23,255,278,96.63681818181817
91,2631622569,YEWNMGQYSNSGTRKSGTWTNALS,23,255,278,95.23636363636363
92,2635642811,YEWNWGGNALSTGKQVDQTVS,20,269,289,98.19947368421053
93,2636509363,YEWNMGQYSNSGTRKQGTWTKALS,23,255,278,95.31090909090909
94,2636645018,YEWNMGSTRSDLSDEEQTIS,19,240,259,95.4561111111111
95,2641419026,YEWNWGTNVTQSTSKVVDQTVS,21,264,285,97.52700000000002
96,2644262238,YEWNWGTNVLSTGKQVDQTVS,20,269,289,98.15526315789471
97,2644437127,YEWNWGDNALNTGKQVDQTVS,20,266,286,98.0921052631579
98,2645861674,YEWNWGTNALGTGKQVDQTVS,20,269,289,98.17421052631579
99,2649292179,YEWNWGTNALATGKQVDQSVS,20,261,281,98.03947368421053
100,2654354322,YEWNMGSTRSDLSDEEQTIS,19,240,259,95.055
101,2654356166,YEWAMGQYAGTGTRAEGTWTSSLS,23,254,277,96.53909090909093
102,2661929472,YEWNMGQYSNSGTRKQGTWTKALS,23,255,278,97.13499999999999
103,2663663996,YEWMMGQFSSDGTRADGTWTKMLS,23,251,274,97.83909090909091
104,2663801603,YEWNMGQYSNSGTRKSGTWTKALS,23,250,273,97.22500000000001
105,2676252688,YEWNWGANDLSTGKQVDQTVS,20,265,285,97.92
106,2685198825,YEWNWGTNALSTGKQVDRTVA,20,275,295,97.80263157894737
107,2685210361,YEWNWGTNALSTGKQADQTVS,20,269,289,98.02526315789476
108,2688359802,YEWMMGQFASTDTRASDAWTKLLS,23,246,269,96.82272727272729
109,2697184229,YEWNMGQYATTGTRKSGTWTKALS,23,254,277,95.85818181818182
110,2702467603,YEWCWGGNALSSGEQADRTVS,20,264,284,97.36263157894736
111,2723987974,YEWNLGVTRTGLSEDMQALS,19,231,250,95.58055555555556
112,2725337609,YEWMMGQFSTAGNRADGTWTASLS,23,254,277,95.71636363636365
113,2731590348,YEWNWGTNVTQSTGKVVDQSVS,21,254,275,97.73299999999999
114,2731610882,YEWNWGTNVTQSTGKVVDQSVS,21,254,275,97.62750000000001
115,2733488751,YEWNMGQYSNSGTRKQGTWTKALS,23,255,278,96.48772727272727
116,2743529465,YEWNMGQYSNSGTRKSGTWTKALS,23,250,273,97.17318181818183
117,2745152095,YEWNMGQYSNSGTRKQGTWTKALS,23,255,278,96.04227272727275
118,2745546911,YEWNMGQYSNSGTRKQGTWTKALS,23,255,278,96.2409090909091
119,2753158319,YEWCQGQYCADPSRADGTWTQLLS,23,248,271,95.6268181818182
120,2755298023,YEWNMGQYARSSDSFTGALS,19,234,253,96.02666666666666
121,2766268657,YEWNWGANDLSTGKQVDQTVS,20,266,286,97.9278947368421
122,2767881435,YEWNWGANDLSTGKTVDQTVS,20,269,289,97.82315789473684
123,2768039407,YEWNWGTNVTQSTGKVVDQTVS,21,254,275,97.23500000000003
124,2768110288,YEWNWGTNDLSTGKQVDQTVS,20,265,285,98.10526315789471
125,2771870499,YEWNMGQYITAGTRADSTWTSALS,23,270,293,96.92636363636362
126,2772467531,YEWNWGANKLSTGKQVDQTVS,20,262,282,97.94947368421053
127,2773978781,YEWNWGTNVTQSTGKVVDQSVS,21,254,275,97.865
128,2774734325,YEWNMGQYSNSGTCKQGTWTKALS,23,255,278,96.22227272727272
129,2776324838,YEWMMGQFADADTRADGSWTKLLS,23,247,270,96.60772727272727
130,2777182996,YEWNWGTNTLAGGKQVDQAVS,20,258,278,97.73473684210525
131,2777946331,YEWSMGSTRSDLSTEEQTIS,19,234,253,92.55388888888889
132,2785369462,YEWNWGGNALSTGKQVDQTVS,20,262,282,98.17368421052633
133,2786651172,YEWNWGTNDLSTGAQVDQSVS,20,258,278,97.94736842105262
134,2786670570,YEWNWGTNVTASTGKTVDQTVS,21,260,281,97.6235
135,2786684491,YEWNWGSNDLSTGKQVDQTVS,20,268,288,98.02894736842104
136,2789340305,YEWMMGQFSHEGARAEGSFGQALS,23,265,288,96.46
137,2790741903,YEWGSGQYASDGTRAEGTWTRALS,23,245,268,97.01954545454545
138,2790744589,YEWSQGQYAAEGTRAEGTWTRLLS,23,256,279,97.55727272727269
139,2790746446,YEWGQGQYASEATRAEGTWTRLFS,23,244,267,97.22863636363635
140,2790749455,YEWAMGQYASDATRAEGTWTRALS,23,250,273,97.57272727272726
141,2790753388,YEWCQGQYGADPSRADGTWTQLLS,23,240,263,96.37681818181818
142,2792388898,YEWMLGQRSQADSRAEGSWTRLLS,23,245,268,95.33818181818182
143,2794159888,YEWNWGTNDLATGKQVDQSVS,20,257,277,98.21263157894738
144,2798895369,YEWNWGTNALATGKQVDQSVS,20,261,281,98.08526315789474
145,2798901129,YEWNWGSNATSSGSQVDQTVS,20,257,277,97.46052631578947
146,2798936322,YEWNWGTNALRTGEVVDQTVS,20,268,288,97.98263157894738
147,2800247947,YEWMLGTTRTGLSDEEQSIS,19,232,251,94.69722222222222
148,2800257106,YEWMMGVTRTDLSDEEQSIS,19,239,258,92.37444444444442
149,2800264098,YEWMLGTTRNDLSEEEQAIS,19,254,273,95.55055555555555
150,2800272269,YEWMMGSTRSGLSDEEQSIS,19,236,255,94.03222222222223
151,2800635855,YEWNMGSTRSGLSDEEQEIS,19,256,275,95.00499999999998
152,2800691517,YEWNMGSTRSGLSDEEQEIS,19,265,284,95.43555555555555
153,2800698379,YEWNMGSTRSGLSDEEQEIS,19,256,275,94.85222222222221
154,2800734521,YEWQMGNTRTSLSDEELTLS,19,265,284,92.93055555555556
155,2800742131,YEWNMGVTRTDLTGEEQSIS,19,255,274,93.95000000000002
156,2800827582,YEWMMGQFADDGARADGTWTQALS,23,242,265,97.07545454545453
157,2800836454,YEWQMGQYSTDGTRADGQWTQLLS,23,249,272,97.52045454545456
158,2805031640,YEWNWGSNATGSGSTVDQTVS,20,256,276,96.82526315789475
159,2805387677,YEWNMGQYSNSGKRKDNTFTGQLS,23,263,286,97.62181818181817
160,2805392336,YEWNMGQYSNSGKRKDNTFTGQLS,23,263,286,97.44090909090909
161,2805394774,YEWNMGQYSNSGKRKDNTFTGQLS,23,263,286,97.60772727272729
162,2805467496,YEWNMGQYSNSGKRKDNTFTGQLS,23,263,286,97.58045454545453
163,2805551944,YEWNMGQYSNSGKRKDNTFTGQLS,23,263,286,97.57681818181817
164,2805601234,YEWNMGQYSNSGKRKDNTFTGQLS,23,263,286,97.56227272727273
165,2808842023,YEWNWGGNALSTGKQVDQTVS,20,261,281,98.13157894736842
166,2808920540,YEWNWGANATQSTGKVVDQSVS,21,248,269,97.89250000000001
167,2812824980,YEWNMGQYSNSGTRKQGTWTKALS,23,255,278,96.39363636363638
168,2812990800,YEWNMGQYSNSGTRKQGTWTKALS,23,255,278,96.53636363636365
169,2813246512,YEWQMGQYTNSNSRKNKTFQKALS,23,264,287,96.8990909090909
170,2813283681,YEWQMGQYTNSNSRKNKTFQKALS,23,264,287,97.03272727272726
171,2813287926,YEWQMGQYTNSNSRKNKTFQKALS,23,264,287,97.24272727272727
172,2826332774,YEWQMGQYGNEGNRKKNSFQKQLS,23,264,287,95.53363636363638
173,2826335383,YEWQMGQYGNEGNRKKNSFQKQLS,23,264,287,95.6590909090909
174,2826338038,YEWQMGQYGNEGNRKKNSFQKQLS,23,264,287,96.16045454545456
175,2826347370,YEWQMGQYGNEGNRKKNSFQKQLS,23,264,287,95.44045454545454
176,2831425956,YEWMMGSTRSGLSDEEQSIS,19,236,255,95.33444444444444
177,2834105888,YEWMMGQFSTAGNRADGTWTAALS,23,252,275,95.68272727272725
178,2837623044,YEWMMGQFSTAGNRADGTWTAALS,23,252,275,95.71181818181817
179,2840801686,YEWGAGQYASADTRAEGTWTRALS,23,246,269,97.78409090909089
180,2841219448,YEWAMGQYSAGGTRAEGTWTRQLS,23,246,269,97.24772727272729
181,2846498488,YEWMMGQFSTAGNRADGTWTAALS,23,252,275,96.52909090909093
182,2846501797,YEWMMGQFSTAGNRADGTWTAALS,23,252,275,96.14090909090909
183,2846504933,YEWAMGQYSAEGTRVEGAWTRQLS,23,255,278,97.43454545454547
184,2851424282,YEWNMGQYSNSGTRKQGTWTKALS,23,255,278,96.14136363636362
185,2862285611,YEWNWGANATGSGSTVDGTVS,20,263,283,95.98526315789475
186,2865153889,YEWCQGQYATDGTRAEGSWTRLLS,23,256,279,96.89090909090906
187,2866956199,YEWMMGQFSTAATRADGTWTAALS,23,251,274,95.50409090909089
188,2866957454,YEWAMGQYSAEGTRAEGAWTRQLS,23,255,278,96.93363636363638
189,2867631196,YEWNWGTNELSTGKQVDQAVS,20,262,282,98.08052631578946
190,2867663697,YEWNWGTNDLSTGEQVDQTVS,20,261,281,97.65157894736842
191,2872781297,YEWNWGTNALSTGKQVDQTVS,20,266,286,98.18894736842105
192,2873090557,YEWNWGANATQSTGKVVDQSVS,21,261,282,97.83700000000002
193,2882241440,YEWNMGQFATTNTRAEDTWTSALS,23,276,299,97.79636363636364
194,2895297582,YEWMMGQFSSDDARADGTWTAQFS,23,255,278,96.24136363636363
195,2900922251,YEWNMGQYSNSGTRKQGTWTKALS,23,255,278,97.195
196,2907612462,YEWNMGQYSTSRTRASGTFTKALS,23,255,278,96.92818181818183
197,2910157584,YEWNMGLTRTNLDSQTQALS,19,333,352,96.09833333333333
198,2911594683,YEWGAGQYASADTRAEGTWTRALS,23,250,273,97.81090909090908
199,2911617436,YEWCQGQYADGGERAEGTWTRELS,23,244,267,95.70636363636366
200,2916502694,YEWNMGQYSNSGTRKQGTWTKALS,23,255,278,95.25454545454545
201,2917284031,YEWNMGSTRSDLSDEEQTIS,19,240,259,95.32444444444444
202,2923490717,YEWMMGQFASTDTRADGTWTKLLS,23,255,278,96.92136363636364
203,2925440118,YEWNMGQYSNSGTRKQGTWTKALS,23,255,278,96.51363636363637
204,637389931,YEWQFNGINDWHRYQPVAGTTKNGRPKFEPVSGQLTVEEQALS,42,216,258,97.61999999999999
205,646037829,YEWQFGGIRDYCRTRHKKTEHGIVRIQEDGTMTDRQMELS,39,245,284,91.01842105263157
206,646038830,YEWEFCGFDDYYWGEKSGVMSEEQKKLS,27,215,242,96.65615384615384
207,648819057,YEWMFQAKKIYTFNSRVRPQIINKRQQLLS,29,206,235,95.14142857142859
208,650748690,YEWNMGSTRSDLSDEEQTIS,19,16,35,96.99277777777776
209,2518420498,YEWQFDGINDWNRSQPVAGSMKNGRPKFEPITGTLSASDQSLS,42,216,258,96.74707317073171
210,2545540001,YEWQFNGINDWNRSQPVAGSMKNGRPKFESITGTLSASDQSLS,42,216,258,92.66951219512195
211,2559698877,YEWMMGQFSHEGARAEGSFGQALS,23,277,300,96.45818181818184
212,2572637226,YEWQFNGINDWHRYQPVAGTAVNGRPQFEPVSGVLDSEAQALS,42,216,258,96.22829268292683
213,2580247201,YEWQFNGINDWHRYQPVAGTTKNGRPKFEPVSGQLTVEEQALS,42,216,258,97.76585365853657
214,2581305531,YEWQFNGINDWHRYQPVAGTTKNGRPKFEPVSGQLTVEEQALS,42,216,258,97.6748780487805
215,2587225559,YEWNMGQYSNSGTRKQGTWTKALS,23,16,39,96.41409090909092
216,2596287002,YEWMFQAKKIYTFNSRVRPQIINKRQQLLS,29,206,235,94.93749999999997
217,2597909647,YEWQFNGINDWNRSQPVAGSMKNGRPKFESITGTLSATDQSLS,42,216,258,96.13682926829269
218,2599312445,YEWMFQAKKIYTFNSRVRPQIINKRQQLLS,29,206,235,95.56785714285714
219,2608465151,YEWMFQAKKIYTFNSRVRPQIINKRQQLLS,29,206,235,95.09464285714283
220,2608983103,YEWMFQAKKIYTFNSRVRPQIINKRQQLLS,29,206,235,95.77035714285715
221,2612392617,YEWQFNGINDWHRYQPVAGTAVNGRPKFEPVSGVLDSEAQALS,42,216,258,96.76073170731709
222,2621025926,YEWMFQAKKIYTFNSRVRPQIINKRQQLLS,29,206,235,95.14249999999997
223,2621080637,YEWEFCGINDYHKMKFERIEGSPKPKLVPISGEMNELQIELS,41,217,258,88.96225
224,2641120372,YEWQFNGINDWNRSQPVAGSMKNGRPKFESITGTLSANDQSLS,42,216,258,96.08146341463413
225,2642101342,YEWQFNGINDWHRYQPVAGTTKNGRPKFEPVSGQLTVEEQALS,42,216,258,97.76536585365851
226,2649694916,YEWQFNGINDWHRYQPVAGTTKNGRPKFEPVSGQLTVEEQALS,42,216,258,97.73829268292683
227,2656988094,YEWEFCGINEYHTMKFGYPESGEDKPEITSVDVCMTDVQKQMS,42,216,258,84.42365853658539
228,2673085225,YEWQFNGINDWHRYQPVAGTTKNGRPKFEPVSGQLTVEEQALS,42,216,258,97.45560975609753
229,2701455799,YEWQFNGINDWNRSQPVAGSMKNGRPKFESITGTLSANDQSLS,42,216,258,96.86731707317074
230,2734583469,YEWNMGQYSNSGTRKSGTWTKALS,23,218,241,97.24772727272726
231,2745503175,YEWQFNGINDWHRYQPVAGTTKNGRPKFEPVSGQLTVEEQALS,42,216,258,97.52268292682925
232,2771784190,YEWEFGGLSDYHWGDREGVMTEAQNMLS,27,215,242,95.37692307692305
233,2777374232,YEWNWGANDLSTGKPVDQTVS,20,284,304,98.04578947368421
234,2790456210,YEWEFHTLLEYHMVTFLPPRDGEKEPRKLNKDGLLTAHQQTLS,42,215,257,89.99926829268293
235,2791281950,YEWEFCGRNHWSGRIGEGDLSEEQIRLS,27,209,236,96.84769230769228
236,2793572515,YEWEFCGINDYHKMKFERIEESRKPKLVPISREMNELQIELS,41,217,258,87.92275000000002
237,2800727165,YEWNMGSTRSGLSDEEQEIS,19,138,157,96.24055555555555
238,2808082563,YEWEFCGLNDYSKKIEIPPQEGETDATFIVDEGTMTEAQQKMA,42,215,257,89.65073170731708
239,2808295654,YEWEFCGLNDYSKKIEIPPQEGETDPTFIVDEGMMTEAQQKMA,42,215,257,90.41073170731705
240,2810452938,YEWQFHNVNDYRRMSMRLEGGRPSFTPEDGTMTDDQIRIS,39,214,253,90.25157894736843
241,2812825829,YEWQFNGINDWNRSQPVAGSMKNGRPKFESITGTLSASDQSLS,42,216,258,96.25414634146341
242,2812989787,YEWQFDGINDWNRSQPVAGSMKNGRPKFEPITGTLSANDQSLS,42,216,258,96.70268292682924
243,2815614087,YEWQFGDIRDYCRTRHKKTEHGIVRIQEDGTMTDRQMELS,39,245,284,90.04421052631578
244,2832934002,YEWLFHGLNDYKKKKIERVNGEIIKTPIKGTMSADQIALS,39,216,255,92.07973684210526
245,2835246207,YEWEFCGLNDYSKKIEIPPQEGETDPTFIVDEGTMTEAQQKMA,42,215,257,89.88804878048781
246,2842958932,YEWEFCGFDDYYWGEKSGVMSEEQKKLS,27,215,242,95.4626923076923
247,2844122133,YEWLFRKESVFHMMKFEMSPKGPKMIPVVGELSEEQKKLS,39,231,270,90.32026315789474
248,2882850827,YEWEFCGLNEFSKKIEIPPQEGESNPTFIVDEGTMTEEQQKMA,42,216,258,90.66536585365853
249,2885675413,YEWQFNGLNTWHSQQFTRVGDRMQVTPVAGKLTAKEQALS,39,214,253,92.69921052631577
250,2915416054,YEWLFQKESVFHMMKFEMSPEGPKMIPVAGELDEEQRKLS,39,234,273,89.39815789473685
251,2917284871,YEWMFQVKKIYTFNSRVRPQIINKRQQLLS,29,206,235,95.56392857142858
252,2923823150,YEWEFCGLNDYSKKIEIPPQEGETDPTFIVDEGTMTEAQQKMA,42,215,257,90.55731707317075
253,2925425477,YEWQFNGINDWHRYQPVAGTTKNGRPKFEPVSGQLTVEEQALS,42,216,258,97.80317073170733
254,2925436013,YEWQFNGINDWHRYQPVAGTTKNGRPKFEPVSGQLTVEEQALS,42,216,258,97.57731707317073
255,2925440967,YEWQFDGINDWNRSQPVAGSMKNGRPKFEPITGTLSASDQSLS,42,216,258,93.30658536585368
256,4j0h_A,YEWQFNGINDWHRYQPVAGTTKNGRPKFEPVSGQLTVEEQALS,42,217,259,1.0
257,6yq4_A,YEWMYNGVNSYSRMEFTRNTSAQEYNDRSLTRSTVQGNLTNDEINIS,46,219,265,1.0
258,7q6y_A,YEWQFCGYNDYHRIKHVRSESGVKNIQIDGILTEKQIKIS,39,228,267,1.0
