,ID,Needle,Needle_length,Needle_start,Needle_stop
0,TanAAp,YEWSAGQYADATDSRAEGVWTQPLS,24,252,276
1,TanALp,YEWNMGQYSNSGTRKQGTWTKALS,23,255,278
2,TanASl,YEWQMGQYGNEGNRKKNSFQKQLS,23,264,287
3,TanASg,YEWNMGSTRSDLSDEEQTIS,19,240,259
4,TanBFnp,YEWMYNGVNSYSRMEFTRNTSAQEYNDRSLTRSTVQGNLTEDEIKIS,46,225,271
5,TanBLpa,YEWQFNGINDWHRYQPVAGTAVNGRPKFEPVSGVLDSEAQALS,42,216,258
6,TanBLpe,YEWQFNGINDWNRSQPVAGSMKNGRPKFESITGTLSASDQSLS,42,216,258
7,TanBLp,YEWQFNGINDWHRYQPVAGTTKNGRPKFEPVSGQLTVEEQALS,42,216,258
8,TanBSg,YEWMFQAKKIYTFNSRVRPQIINKRQQLLS,29,206,235
9,TanBSs,YEWNWGTNTLATGKQVDQAVS,20,262,282
10,TanCb1,YEWNMGQYFTTDTRDSSSFKSALS,23,254,277
11,TanCb2,YEWQFCGYNDYHRIKHVRSESGVKNIQIDGILTEKQIKIS,39,228,267
12,TanCb3,YEWLFNGLNDYEKMNISKDENGNIKREKQSLTQTEDQIKYS,40,254,294
13,641746432,YEWMYNGVNSYSRMEFTRNTSAQEYNDRSLTRSTVQGNLTEDEIKIS,46,225,271
14,647526067,YEWMYNGVNSYSRMEFTRNTSAQEYNDRSLTRSTVQGNLTNDEINIS,46,225,271
15,2505790797,YEWQLNKIHAFKFRGREGTLDAEALKVS,27,218,245
16,2509549983,YEWELGVARTNLSAETKEVS,19,221,240
17,2511056385,YEWMMGVTRSGLTDEQQAIS,19,377,396
18,2515271184,YEWQFNGVNNYAKRGGGGPAGGGMPQQATVASLTDDQIRVS,40,230,270
19,2520858584,YEWMYNGVNSYLRMEFTKNTSAQEYNDRSLTHSTVQGNLTDNEIKVS,46,224,270
20,2532577375,YEWMYNGVNSYLRMEFTKNTSAQEYNDRSLTHSTVQGNLTDNEIKVS,46,225,271
21,2554439104,YEWMYNGVNSYSRMEFTKNTSAQEYNDRSLTRSTVQGNLTDNEIKVS,46,225,271
22,2554441166,YEWMYNGVNSYSRMEFTRNTSAQEYNDRSLTHSTVQGNLTNDEINIS,46,225,271
23,2559352011,YEWQFNGVNEYSRMDMSRLNADSYNNRSKPMPKIEGSLSELEIRVS,45,233,278
24,2559386245,YEWQFNGVNEFSRIDMSKLNSAEFNDRSKPMPKIEGTLSEAEIKLS,45,233,278
25,2561336272,YEWMYNGVNSYSRMEFTKNTSAKEYNDRSLTHSTVQGNLTEDEIKIS,46,225,271
26,2561339177,YEWMYNGVNSYSRMEFTKNTSAQEYNDRSLTRSTVQGNLTEDEIKIS,46,225,271
27,2561341273,YEWMYNGVNSYSRMEFTKNTSAQEYNDRSLTRSTVQGNLTEDEIKIS,46,225,271
28,2564011747,YEWMYNGVNSYSRMDFTRNTSAQEYNDRSLTHSTVQGNLTNDEINIS,46,225,271
29,2567017550,YEWMYNGVNSYSRMEFTRNTSAQEYNDRSLTRSTVQGNLTEDEIKIS,46,225,271
30,2567022283,YEWMYNGVNSYSRMEFTKNTSAKEYNDRSLTHSTVQGNLTEDEIKIS,46,225,271
31,2567202592,YEWMYNGVNSYSRMEITRNTSAEEYNDRSLTRSTVQGNLTEDEIKIS,46,225,271
32,2567372575,YEWMYNGVNSYSRMVFSENTTAEEYNDRSLTHSTVQGNLTEDEIKIS,46,225,271
33,2567373568,YEWMYNGVNSYSRMEITRNTSAEEYNDRSLTRSTVQGNLTEDEIKTS,46,227,273
34,2567377351,YEWMYNGVNSYSRMVFSENTTAEEYNDRSLTHSTVQGNLTEDEIKIS,46,225,271
35,2635528200,YEWMYNGVNSYSRMEFTRNTSAQEYNDRSLTRSTVQGNLTNDEINIS,46,225,271
36,2678400947,YEWMYNGVNSYSRMEFTRNTSAQEYNDRSLTRSTVQGNLTNDEINIS,46,225,271
37,2705769279,YEWELGVARTGLDSETKAVS,19,222,241
38,2765624323,YEWMYNGVNSYSRMEFTRNTSAQEYNDRSLTHSTVQGNLTNDEINIS,46,225,271
39,2813373532,YEWQFNGVNDYEKIDISMLDYRVERKTVRGTQTAEQQRLS,39,224,263
40,2813878675,YEWQFNGYNDYKKMDISMLDYHIQRKETKGTLTNDQQVVS,39,216,255
41,2843925074,YEWMYNGVNSYLRMEFTKNTSEQEYNDRSLTHSTVQGNLTDNEIKVS,46,225,271
42,2847470013,YEWMYNGVDSYSRMEFTRNTSAQEYNDRSLTRSTVQGNLTEDEIKIS,46,225,271
43,2849014119,YEWMYNGVNSYSRMEFTRNTSAQEYNDRSLTRSTVQGNLTNDEINIS,46,225,271
44,2856181804,YEWMYNDVNSYSRMEFTRNTSAQEYNDRSLTHSIVQGNLTDEEIKIS,46,224,270
45,2856190891,YEWMYNGVNSYSRMEFTKNTSAQEYNDRSLTRSTVQGNLTEDEIKIS,46,225,271
46,2859119394,YEWMYNGVNSYSRMEFTRNTSAQEYNDRSLTRSTVQGNLTEDEIKIS,46,225,271
47,2859120770,YEWMYNGVNSYSRMEFTRNTSAQEYNDRSLTRSTVQGNLTEDEIKIS,46,225,271
48,2859127800,YEWMYNGVNSYSRMEFTKNTSAQEYNDRSLTRSTVQGNLTEDEIKIS,46,225,271
49,2859139131,YEWMYNGVNSYSRMEFTKNTSAQEYNDRSLTRSTVQGNLTEDEIKIS,46,225,271
50,2869309611,YEWMYNGVNSYSRMGFTKNTSAKEYNDRSLTHSTVQGNLTEDEIKIS,46,225,271
51,637258864,YEWMYNGVNSYSRMEFTRNTSAQEYNDRSLTRSTVQGNLTNDEINIS,46,219,265
52,646254125,YEWMYNGVNSYSRMEFTRNTSAQEYNDRSLTRSIVQGNLTDEEIKIS,46,229,275
53,646256224,YEWMYNGVNSYLRMEFTKNTSAQEYNDRSLTHSTVQGNLTDNEIKVS,46,229,275
54,644252663,YEWSAGQYADGDTRASGTWTHALS,23,254,277
55,648818377,YEWNMGSTRSDLSDEEQTIS,19,240,259
56,651076336,YEWNMGSTRSDLSDEEQTIS,19,240,259
57,2515594305,YEWNWGGNKLNSGARVDQSVS,20,259,279
58,2518419131,YEWNMGQYSNSGTRKQGTWTKALS,23,255,278
59,2518695199,YEWNMGQYSTSGTRASGTFTKALS,23,255,278
60,2518712047,YEWNMGQYSTSGTRASGTFTKALS,23,255,278
61,2521682749,YEWNWGGNALSTGKQVDQTVS,20,263,283
62,2521772704,YEWNWGTNALGTGKQVAQAVS,20,257,277
63,2525441047,YEWMMGTTRSGLTDEEQSIS,19,254,273
64,2525509443,YEWMMGTTRSGLTEEEQSIS,19,254,273
65,2525512195,YEWMMGTTRSGLTDEEQSIS,19,254,273
66,2526247906,YEWMMGTTRSGLTDEEQSIS,19,254,273
67,2541461213,YEWSAGQYVTSDSRAEGLWTKALS,23,253,276
68,2541814430,YEWMMGQFSDEGARAEGSFGGALS,23,265,288
69,2545784013,YEWMMGTTRSDLTQEEQSIS,19,249,268
70,2549870083,YEWQFSGIYTYKKLQMPANTDFNAERVWVEGTLTEDQIRVS,40,221,261
71,2553000633,YEWQMGQYTNSNSRKNKTFQKELS,23,264,287
72,2559783787,YEWMMGQFASTDTRADGTWTKLLS,23,255,278
73,2561325321,YEWSAGQYADATDSRAEGVWTQPLS,24,252,276
74,2561327489,YEWSAGQYADATDSRAEGVWTQPLS,24,252,276
75,2561459174,YEWNMGNTRTDLTDEEQEIS,19,243,262
76,2562201711,YEWQMGNTRTGLSEEEQKIS,19,252,271
77,2562551738,YEWMMGTTRSGLTDEEQSIS,19,259,278
78,2563232424,YEWNMGQYSTSGTRASGTFTKALS,23,255,278
79,2571114083,YEWMMGTTRSDLTDEEQSVS,19,248,267
80,2582171838,YEWNMGQYSNSGTRKQGTWTKALS,23,255,278
81,2585308755,YEWNWGTNALSTGKQVDQTVS,20,261,281
82,2586993216,YEWNMGQYSNSGTRKQGTWTKALS,23,255,278
83,2598962618,YEWNMGQYSNSGTRKQGTWTKALS,23,255,278
84,2599311692,YEWNMGSTRSDLSDEEQTIS,19,240,259
85,2600401283,YEWQMGQYTNSNSRKNKTFQKALS,23,264,287
86,2601013064,YEWSAGQYADATDSRAEGVWTQPLS,24,252,276
87,2608461850,YEWMMGQFSTAGNRADGTWTASLS,23,255,278
88,2609146504,YEWMMGQFSSDGTRADGTWTKMLS,23,251,274
89,2624521198,YEWMFNGINDYEGRTTKGTLTKEQTEIS,27,222,249
90,2629350457,YEWNMGQYSNSDTRANDTWTSALS,23,258,281
91,2630154569,YEWNMGQYANSGTRKPGTWTKALS,23,255,278
92,2631622569,YEWNMGQYSNSGTRKSGTWTNALS,23,255,278
93,2635642811,YEWNWGGNALSTGKQVDQTVS,20,269,289
94,2636509363,YEWNMGQYSNSGTRKQGTWTKALS,23,255,278
95,2636645018,YEWNMGSTRSDLSDEEQTIS,19,240,259
96,2641419026,YEWNWGTNVTQSTSKVVDQTVS,21,264,285
97,2644262238,YEWNWGTNVLSTGKQVDQTVS,20,269,289
98,2644437127,YEWNWGDNALNTGKQVDQTVS,20,266,286
99,2645861674,YEWNWGTNALGTGKQVDQTVS,20,269,289
100,2649292179,YEWNWGTNALATGKQVDQSVS,20,261,281
101,2654354322,YEWNMGSTRSDLSDEEQTIS,19,240,259
102,2654356166,YEWAMGQYAGTGTRAEGTWTSSLS,23,254,277
103,2661929472,YEWNMGQYSNSGTRKQGTWTKALS,23,255,278
104,2663663996,YEWMMGQFSSDGTRADGTWTKMLS,23,251,274
105,2663801603,YEWNMGQYSNSGTRKSGTWTKALS,23,250,273
106,2676252688,YEWNWGANDLSTGKQVDQTVS,20,265,285
107,2685198825,YEWNWGTNALSTGKQVDRTVA,20,275,295
108,2685210361,YEWNWGTNALSTGKQADQTVS,20,269,289
109,2688359802,YEWMMGQFASTDTRASDAWTKLLS,23,246,269
110,2697184229,YEWNMGQYATTGTRKSGTWTKALS,23,254,277
111,2702467603,YEWCWGGNALSSGEQADRTVS,20,264,284
112,2723987974,YEWNLGVTRTGLSEDMQALS,19,231,250
113,2725337609,YEWMMGQFSTAGNRADGTWTASLS,23,254,277
114,2731590348,YEWNWGTNVTQSTGKVVDQSVS,21,254,275
115,2731610882,YEWNWGTNVTQSTGKVVDQSVS,21,254,275
116,2733488751,YEWNMGQYSNSGTRKQGTWTKALS,23,255,278
117,2743529465,YEWNMGQYSNSGTRKSGTWTKALS,23,250,273
118,2745152095,YEWNMGQYSNSGTRKQGTWTKALS,23,255,278
119,2745546911,YEWNMGQYSNSGTRKQGTWTKALS,23,255,278
120,2753158319,YEWCQGQYCADPSRADGTWTQLLS,23,248,271
121,2755298023,YEWNMGQYARSSDSFTGALS,19,234,253
122,2766268657,YEWNWGANDLSTGKQVDQTVS,20,266,286
123,2767881435,YEWNWGANDLSTGKTVDQTVS,20,269,289
124,2768039407,YEWNWGTNVTQSTGKVVDQTVS,21,254,275
125,2768110288,YEWNWGTNDLSTGKQVDQTVS,20,265,285
126,2771870499,YEWNMGQYITAGTRADSTWTSALS,23,270,293
127,2772467531,YEWNWGANKLSTGKQVDQTVS,20,262,282
128,2773978781,YEWNWGTNVTQSTGKVVDQSVS,21,254,275
129,2774734325,YEWNMGQYSNSGTCKQGTWTKALS,23,255,278
130,2776324838,YEWMMGQFADADTRADGSWTKLLS,23,247,270
131,2777182996,YEWNWGTNTLAGGKQVDQAVS,20,258,278
132,2777946331,YEWSMGSTRSDLSTEEQTIS,19,234,253
133,2785369462,YEWNWGGNALSTGKQVDQTVS,20,262,282
134,2786651172,YEWNWGTNDLSTGAQVDQSVS,20,258,278
135,2786670570,YEWNWGTNVTASTGKTVDQTVS,21,260,281
136,2786684491,YEWNWGSNDLSTGKQVDQTVS,20,268,288
137,2789340305,YEWMMGQFSHEGARAEGSFGQALS,23,265,288
138,2790741903,YEWGSGQYASDGTRAEGTWTRALS,23,245,268
139,2790744589,YEWSQGQYAAEGTRAEGTWTRLLS,23,256,279
140,2790746446,YEWGQGQYASEATRAEGTWTRLFS,23,244,267
141,2790749455,YEWAMGQYASDATRAEGTWTRALS,23,250,273
142,2790753388,YEWCQGQYGADPSRADGTWTQLLS,23,240,263
143,2792388898,YEWMLGQRSQADSRAEGSWTRLLS,23,245,268
144,2794159888,YEWNWGTNDLATGKQVDQSVS,20,257,277
145,2798895369,YEWNWGTNALATGKQVDQSVS,20,261,281
146,2798901129,YEWNWGSNATSSGSQVDQTVS,20,257,277
147,2798936322,YEWNWGTNALRTGEVVDQTVS,20,268,288
148,2800247947,YEWMLGTTRTGLSDEEQSIS,19,232,251
149,2800257106,YEWMMGVTRTDLSDEEQSIS,19,239,258
150,2800264098,YEWMLGTTRNDLSEEEQAIS,19,254,273
151,2800272269,YEWMMGSTRSGLSDEEQSIS,19,236,255
152,2800635855,YEWNMGSTRSGLSDEEQEIS,19,256,275
153,2800691517,YEWNMGSTRSGLSDEEQEIS,19,265,284
154,2800698379,YEWNMGSTRSGLSDEEQEIS,19,256,275
155,2800734521,YEWQMGNTRTSLSDEELTLS,19,265,284
156,2800742131,YEWNMGVTRTDLTGEEQSIS,19,255,274
157,2800827582,YEWMMGQFADDGARADGTWTQALS,23,242,265
158,2800836454,YEWQMGQYSTDGTRADGQWTQLLS,23,249,272
159,2805031640,YEWNWGSNATGSGSTVDQTVS,20,256,276
160,2805387677,YEWNMGQYSNSGKRKDNTFTGQLS,23,263,286
161,2805392336,YEWNMGQYSNSGKRKDNTFTGQLS,23,263,286
162,2805394774,YEWNMGQYSNSGKRKDNTFTGQLS,23,263,286
163,2805467496,YEWNMGQYSNSGKRKDNTFTGQLS,23,263,286
164,2805551944,YEWNMGQYSNSGKRKDNTFTGQLS,23,263,286
165,2805601234,YEWNMGQYSNSGKRKDNTFTGQLS,23,263,286
166,2808842023,YEWNWGGNALSTGKQVDQTVS,20,261,281
167,2808920540,YEWNWGANATQSTGKVVDQSVS,21,248,269
168,2812824980,YEWNMGQYSNSGTRKQGTWTKALS,23,255,278
169,2812990800,YEWNMGQYSNSGTRKQGTWTKALS,23,255,278
170,2813246512,YEWQMGQYTNSNSRKNKTFQKALS,23,264,287
171,2813283681,YEWQMGQYTNSNSRKNKTFQKALS,23,264,287
172,2813287926,YEWQMGQYTNSNSRKNKTFQKALS,23,264,287
173,2826332774,YEWQMGQYGNEGNRKKNSFQKQLS,23,264,287
174,2826335383,YEWQMGQYGNEGNRKKNSFQKQLS,23,264,287
175,2826338038,YEWQMGQYGNEGNRKKNSFQKQLS,23,264,287
176,2826347370,YEWQMGQYGNEGNRKKNSFQKQLS,23,264,287
177,2831425956,YEWMMGSTRSGLSDEEQSIS,19,236,255
178,2834105888,YEWMMGQFSTAGNRADGTWTAALS,23,252,275
179,2837623044,YEWMMGQFSTAGNRADGTWTAALS,23,252,275
180,2840801686,YEWGAGQYASADTRAEGTWTRALS,23,246,269
181,2841219448,YEWAMGQYSAGGTRAEGTWTRQLS,23,246,269
182,2846498488,YEWMMGQFSTAGNRADGTWTAALS,23,252,275
183,2846501797,YEWMMGQFSTAGNRADGTWTAALS,23,252,275
184,2846504933,YEWAMGQYSAEGTRVEGAWTRQLS,23,255,278
185,2851424282,YEWNMGQYSNSGTRKQGTWTKALS,23,255,278
186,2862285611,YEWNWGANATGSGSTVDGTVS,20,263,283
187,2865153889,YEWCQGQYATDGTRAEGSWTRLLS,23,256,279
188,2866956199,YEWMMGQFSTAATRADGTWTAALS,23,251,274
189,2866957454,YEWAMGQYSAEGTRAEGAWTRQLS,23,255,278
190,2867631196,YEWNWGTNELSTGKQVDQAVS,20,262,282
191,2867663697,YEWNWGTNDLSTGEQVDQTVS,20,261,281
192,2872781297,YEWNWGTNALSTGKQVDQTVS,20,266,286
193,2873090557,YEWNWGANATQSTGKVVDQSVS,21,261,282
194,2882241440,YEWNMGQFATTNTRAEDTWTSALS,23,276,299
195,2895297582,YEWMMGQFSSDDARADGTWTAQFS,23,255,278
196,2900922251,YEWNMGQYSNSGTRKQGTWTKALS,23,255,278
197,2907612462,YEWNMGQYSTSRTRASGTFTKALS,23,255,278
198,2910157584,YEWNMGLTRTNLDSQTQALS,19,333,352
199,2911594683,YEWGAGQYASADTRAEGTWTRALS,23,250,273
200,2911617436,YEWCQGQYADGGERAEGTWTRELS,23,244,267
201,2916502694,YEWNMGQYSNSGTRKQGTWTKALS,23,255,278
202,2917284031,YEWNMGSTRSDLSDEEQTIS,19,240,259
203,2923490717,YEWMMGQFASTDTRADGTWTKLLS,23,255,278
204,2925440118,YEWNMGQYSNSGTRKQGTWTKALS,23,255,278
205,637389931,YEWQFNGINDWHRYQPVAGTTKNGRPKFEPVSGQLTVEEQALS,42,216,258
206,646037829,YEWQFGGIRDYCRTRHKKTEHGIVRIQEDGTMTDRQMELS,39,245,284
207,646038830,YEWEFCGFDDYYWGEKSGVMSEEQKKLS,27,215,242
208,648819057,YEWMFQAKKIYTFNSRVRPQIINKRQQLLS,29,206,235
209,650748690,YEWNMGSTRSDLSDEEQTIS,19,16,35
210,2518420498,YEWQFDGINDWNRSQPVAGSMKNGRPKFEPITGTLSASDQSLS,42,216,258
211,2545540001,YEWQFNGINDWNRSQPVAGSMKNGRPKFESITGTLSASDQSLS,42,216,258
212,2559698877,YEWMMGQFSHEGARAEGSFGQALS,23,277,300
213,2572637226,YEWQFNGINDWHRYQPVAGTAVNGRPQFEPVSGVLDSEAQALS,42,216,258
214,2580247201,YEWQFNGINDWHRYQPVAGTTKNGRPKFEPVSGQLTVEEQALS,42,216,258
215,2581305531,YEWQFNGINDWHRYQPVAGTTKNGRPKFEPVSGQLTVEEQALS,42,216,258
216,2587225559,YEWNMGQYSNSGTRKQGTWTKALS,23,16,39
217,2596287002,YEWMFQAKKIYTFNSRVRPQIINKRQQLLS,29,206,235
218,2597909647,YEWQFNGINDWNRSQPVAGSMKNGRPKFESITGTLSATDQSLS,42,216,258
219,2599312445,YEWMFQAKKIYTFNSRVRPQIINKRQQLLS,29,206,235
220,2608465151,YEWMFQAKKIYTFNSRVRPQIINKRQQLLS,29,206,235
221,2608983103,YEWMFQAKKIYTFNSRVRPQIINKRQQLLS,29,206,235
222,2612392617,YEWQFNGINDWHRYQPVAGTAVNGRPKFEPVSGVLDSEAQALS,42,216,258
223,2621025926,YEWMFQAKKIYTFNSRVRPQIINKRQQLLS,29,206,235
224,2621080637,YEWEFCGINDYHKMKFERIEGSPKPKLVPISGEMNELQIELS,41,217,258
225,2641120372,YEWQFNGINDWNRSQPVAGSMKNGRPKFESITGTLSANDQSLS,42,216,258
226,2642101342,YEWQFNGINDWHRYQPVAGTTKNGRPKFEPVSGQLTVEEQALS,42,216,258
227,2649694916,YEWQFNGINDWHRYQPVAGTTKNGRPKFEPVSGQLTVEEQALS,42,216,258
228,2656988094,YEWEFCGINEYHTMKFGYPESGEDKPEITSVDVCMTDVQKQMS,42,216,258
229,2673085225,YEWQFNGINDWHRYQPVAGTTKNGRPKFEPVSGQLTVEEQALS,42,216,258
230,2701455799,YEWQFNGINDWNRSQPVAGSMKNGRPKFESITGTLSANDQSLS,42,216,258
231,2734583469,YEWNMGQYSNSGTRKSGTWTKALS,23,218,241
232,2745503175,YEWQFNGINDWHRYQPVAGTTKNGRPKFEPVSGQLTVEEQALS,42,216,258
233,2771784190,YEWEFGGLSDYHWGDREGVMTEAQNMLS,27,215,242
234,2777374232,YEWNWGANDLSTGKPVDQTVS,20,284,304
235,2790456210,YEWEFHTLLEYHMVTFLPPRDGEKEPRKLNKDGLLTAHQQTLS,42,215,257
236,2791281950,YEWEFCGRNHWSGRIGEGDLSEEQIRLS,27,209,236
237,2793572515,YEWEFCGINDYHKMKFERIEESRKPKLVPISREMNELQIELS,41,217,258
238,2800727165,YEWNMGSTRSGLSDEEQEIS,19,138,157
239,2808082563,YEWEFCGLNDYSKKIEIPPQEGETDATFIVDEGTMTEAQQKMA,42,215,257
240,2808295654,YEWEFCGLNDYSKKIEIPPQEGETDPTFIVDEGMMTEAQQKMA,42,215,257
241,2810452938,YEWQFHNVNDYRRMSMRLEGGRPSFTPEDGTMTDDQIRIS,39,214,253
242,2812825829,YEWQFNGINDWNRSQPVAGSMKNGRPKFESITGTLSASDQSLS,42,216,258
243,2812989787,YEWQFDGINDWNRSQPVAGSMKNGRPKFEPITGTLSANDQSLS,42,216,258
244,2815614087,YEWQFGDIRDYCRTRHKKTEHGIVRIQEDGTMTDRQMELS,39,245,284
245,2832934002,YEWLFHGLNDYKKKKIERVNGEIIKTPIKGTMSADQIALS,39,216,255
246,2835246207,YEWEFCGLNDYSKKIEIPPQEGETDPTFIVDEGTMTEAQQKMA,42,215,257
247,2842958932,YEWEFCGFDDYYWGEKSGVMSEEQKKLS,27,215,242
248,2844122133,YEWLFRKESVFHMMKFEMSPKGPKMIPVVGELSEEQKKLS,39,231,270
249,2882850827,YEWEFCGLNEFSKKIEIPPQEGESNPTFIVDEGTMTEEQQKMA,42,216,258
250,2885675413,YEWQFNGLNTWHSQQFTRVGDRMQVTPVAGKLTAKEQALS,39,214,253
251,2915416054,YEWLFQKESVFHMMKFEMSPEGPKMIPVAGELDEEQRKLS,39,234,273
252,2917284871,YEWMFQVKKIYTFNSRVRPQIINKRQQLLS,29,206,235
253,2923823150,YEWEFCGLNDYSKKIEIPPQEGETDPTFIVDEGTMTEAQQKMA,42,215,257
254,2925425477,YEWQFNGINDWHRYQPVAGTTKNGRPKFEPVSGQLTVEEQALS,42,216,258
255,2925436013,YEWQFNGINDWHRYQPVAGTTKNGRPKFEPVSGQLTVEEQALS,42,216,258
256,2925440967,YEWQFDGINDWNRSQPVAGSMKNGRPKFEPITGTLSASDQSLS,42,216,258
257,4j0h_A,YEWQFNGINDWHRYQPVAGTTKNGRPKFEPVSGQLTVEEQALS,42,217,259
258,6yq4_A,YEWMYNGVNSYSRMEFTRNTSAQEYNDRSLTRSTVQGNLTNDEINIS,46,219,265
259,7q6y_A,YEWQFCGYNDYHRIKHVRSESGVKNIQIDGILTEKQIKIS,39,228,267
