,ID,Needle,Needle_length,Needle_start,Needle_stop
0,TanAAp,YEWSAGQYADATDSRAEGVWTQPLSQ,25,252,277
1,TanALp,YEWNMGQYSNSGTRKQGTWTKALSN,24,255,279
2,TanASl,YEWQMGQYGNEGNRKKNSFQKQLST,24,264,288
3,TanASg,YEWNMGSTRSDLSDEEQTISD,20,240,260
4,TanBFnp,YEWMYNGVNSYSRMEFTRNTSAQEYNDRSLTRSTVQGNLTEDEIKISN,47,225,272
5,TanBLpa,YEWQFNGINDWHRYQPVAGTAVNGRPKFEPVSGVLDSEAQALSA,43,216,259
6,TanBLpe,YEWQFNGINDWNRSQPVAGSMKNGRPKFESITGTLSASDQSLSA,43,216,259
7,TanBLp,YEWQFNGINDWHRYQPVAGTTKNGRPKFEPVSGQLTVEEQALSL,43,216,259
8,TanBSg,YEWMFQAKKIYTFNSRVRPQIINKRQQLLSQ,30,206,236
9,TanBSs,YEWNWGTNTLATGKQVDQAVSK,21,262,283
10,TanCb1,YEWNMGQYFTTDTRDSSSFKSALSK,24,254,278
11,TanCb2,YEWQFCGYNDYHRIKHVRSESGVKNIQIDGILTEKQIKISE,40,228,268
12,TanCb3,YEWLFNGLNDYEKMNISKDENGNIKREKQSLTQTEDQIKYSN,41,254,295
13,641746432,YEWMYNGVNSYSRMEFTRNTSAQEYNDRSLTRSTVQGNLTEDEIKISN,47,225,272
14,647526067,YEWMYNGVNSYSRMEFTRNTSAQEYNDRSLTRSTVQGNLTNDEINISN,47,225,272
15,2505790797,YEWQLNKIHAFKFRGREGTLDAEALKVSD,28,218,246
16,2509549983,YEWELGVARTNLSAETKEVSD,20,221,241
17,2511056385,YEWMMGVTRSGLTDEQQAISD,20,377,397
18,2515271184,YEWQFNGVNNYAKRGGGGPAGGGMPQQATVASLTDDQIRVSG,41,230,271
19,2520858584,YEWMYNGVNSYLRMEFTKNTSAQEYNDRSLTHSTVQGNLTDNEIKVSN,47,224,271
20,2532577375,YEWMYNGVNSYLRMEFTKNTSAQEYNDRSLTHSTVQGNLTDNEIKVSN,47,225,272
21,2554439104,YEWMYNGVNSYSRMEFTKNTSAQEYNDRSLTRSTVQGNLTDNEIKVSN,47,225,272
22,2554441166,YEWMYNGVNSYSRMEFTRNTSAQEYNDRSLTHSTVQGNLTNDEINISN,47,225,272
23,2559352011,YEWQFNGVNEYSRMDMSRLNADSYNNRSKPMPKIEGSLSELEIRVSN,46,233,279
24,2559386245,YEWQFNGVNEFSRIDMSKLNSAEFNDRSKPMPKIEGTLSEAEIKLSN,46,233,279
25,2561336272,YEWMYNGVNSYSRMEFTKNTSAKEYNDRSLTHSTVQGNLTEDEIKISN,47,225,272
26,2561339177,YEWMYNGVNSYSRMEFTKNTSAQEYNDRSLTRSTVQGNLTEDEIKISN,47,225,272
27,2561341273,YEWMYNGVNSYSRMEFTKNTSAQEYNDRSLTRSTVQGNLTEDEIKISN,47,225,272
28,2564011747,YEWMYNGVNSYSRMDFTRNTSAQEYNDRSLTHSTVQGNLTNDEINISN,47,225,272
29,2567017550,YEWMYNGVNSYSRMEFTRNTSAQEYNDRSLTRSTVQGNLTEDEIKISN,47,225,272
30,2567022283,YEWMYNGVNSYSRMEFTKNTSAKEYNDRSLTHSTVQGNLTEDEIKISN,47,225,272
31,2567202592,YEWMYNGVNSYSRMEITRNTSAEEYNDRSLTRSTVQGNLTEDEIKISN,47,225,272
32,2567372575,YEWMYNGVNSYSRMVFSENTTAEEYNDRSLTHSTVQGNLTEDEIKISN,47,225,272
33,2567373568,YEWMYNGVNSYSRMEITRNTSAEEYNDRSLTRSTVQGNLTEDEIKTSN,47,227,274
34,2567377351,YEWMYNGVNSYSRMVFSENTTAEEYNDRSLTHSTVQGNLTEDEIKISN,47,225,272
35,2635528200,YEWMYNGVNSYSRMEFTRNTSAQEYNDRSLTRSTVQGNLTNDEINISN,47,225,272
36,2678400947,YEWMYNGVNSYSRMEFTRNTSAQEYNDRSLTRSTVQGNLTNDEINISN,47,225,272
37,2705769279,YEWELGVARTGLDSETKAVSD,20,222,242
38,2765624323,YEWMYNGVNSYSRMEFTRNTSAQEYNDRSLTHSTVQGNLTNDEINISN,47,225,272
39,2813373532,YEWQFNGVNDYEKIDISMLDYRVERKTVRGTQTAEQQRLSD,40,224,264
40,2813878675,YEWQFNGYNDYKKMDISMLDYHIQRKETKGTLTNDQQVVSD,40,216,256
41,2843925074,YEWMYNGVNSYLRMEFTKNTSEQEYNDRSLTHSTVQGNLTDNEIKVSN,47,225,272
42,2847470013,YEWMYNGVDSYSRMEFTRNTSAQEYNDRSLTRSTVQGNLTEDEIKISN,47,225,272
43,2849014119,YEWMYNGVNSYSRMEFTRNTSAQEYNDRSLTRSTVQGNLTNDEINISN,47,225,272
44,2856181804,YEWMYNDVNSYSRMEFTRNTSAQEYNDRSLTHSIVQGNLTDEEIKISN,47,224,271
45,2856190891,YEWMYNGVNSYSRMEFTKNTSAQEYNDRSLTRSTVQGNLTEDEIKISN,47,225,272
46,2859119394,YEWMYNGVNSYSRMEFTRNTSAQEYNDRSLTRSTVQGNLTEDEIKISS,47,225,272
47,2859120770,YEWMYNGVNSYSRMEFTRNTSAQEYNDRSLTRSTVQGNLTEDEIKISN,47,225,272
48,2859127800,YEWMYNGVNSYSRMEFTKNTSAQEYNDRSLTRSTVQGNLTEDEIKISN,47,225,272
49,2859139131,YEWMYNGVNSYSRMEFTKNTSAQEYNDRSLTRSTVQGNLTEDEIKISN,47,225,272
50,2869309611,YEWMYNGVNSYSRMGFTKNTSAKEYNDRSLTHSTVQGNLTEDEIKISN,47,225,272
51,637258864,YEWMYNGVNSYSRMEFTRNTSAQEYNDRSLTRSTVQGNLTNDEINISN,47,219,266
52,646254125,YEWMYNGVNSYSRMEFTRNTSAQEYNDRSLTRSIVQGNLTDEEIKISN,47,229,276
53,646256224,YEWMYNGVNSYLRMEFTKNTSAQEYNDRSLTHSTVQGNLTDNEIKVSN,47,229,276
54,644252663,YEWSAGQYADGDTRASGTWTHALSS,24,254,278
55,648818377,YEWNMGSTRSDLSDEEQTISD,20,240,260
56,651076336,YEWNMGSTRSDLSDEEQTISD,20,240,260
57,2515594305,YEWNWGGNKLNSGARVDQSVSK,21,259,280
58,2518419131,YEWNMGQYSNSGTRKQGTWTKALSN,24,255,279
59,2518695199,YEWNMGQYSTSGTRASGTFTKALSN,24,255,279
60,2518712047,YEWNMGQYSTSGTRASGTFTKALSN,24,255,279
61,2521682749,YEWNWGGNALSTGKQVDQTVSK,21,263,284
62,2521772704,YEWNWGTNALGTGKQVAQAVSK,21,257,278
63,2525441047,YEWMMGTTRSGLTDEEQSISD,20,254,274
64,2525509443,YEWMMGTTRSGLTEEEQSISD,20,254,274
65,2525512195,YEWMMGTTRSGLTDEEQSISD,20,254,274
66,2526247906,YEWMMGTTRSGLTDEEQSISD,20,254,274
67,2541461213,YEWSAGQYVTSDSRAEGLWTKALSS,24,253,277
68,2545784013,YEWMMGTTRSDLTQEEQSISD,20,249,269
69,2549870083,YEWQFSGIYTYKKLQMPANTDFNAERVWVEGTLTEDQIRVSN,41,221,262
70,2553000633,YEWQMGQYTNSNSRKNKTFQKELSN,24,264,288
71,2561459174,YEWNMGNTRTDLTDEEQEISD,20,243,263
72,2562201711,YEWQMGNTRTGLSEEEQKISD,20,252,272
73,2562551738,YEWMMGTTRSGLTDEEQSISD,20,259,279
74,2563232424,YEWNMGQYSTSGTRASGTFTKALSN,24,255,279
75,2571114083,YEWMMGTTRSDLTDEEQSVSD,20,248,268
76,2585308755,YEWNWGTNALSTGKQVDQTVSK,21,261,282
77,2586993216,YEWNMGQYSNSGTRKQGTWTKALSN,24,255,279
78,2599311692,YEWNMGSTRSDLSDEEQTISD,20,240,260
79,2600401283,YEWQMGQYTNSNSRKNKTFQKALSN,24,264,288
80,2608461850,YEWMMGQFSTAGNRADGTWTASLSQ,24,255,279
81,2624521198,YEWMFNGINDYEGRTTKGTLTKEQTEISD,28,222,250
82,2629350457,YEWNMGQYSNSDTRANDTWTSALSD,24,258,282
83,2630154569,YEWNMGQYANSGTRKPGTWTKALSN,24,255,279
84,2631622569,YEWNMGQYSNSGTRKSGTWTNALSN,24,255,279
85,2635642811,YEWNWGGNALSTGKQVDQTVSK,21,269,290
86,2636645018,YEWNMGSTRSDLSDEEQTISD,20,240,260
87,2641118398,YEWNMGQYSNSGTRKQGTWTKALSN,24,255,279
88,2641419026,YEWNWGTNVTQSTSKVVDQTVSK,22,264,286
89,2644262238,YEWNWGTNVLSTGKQVDQTVSK,21,269,290
90,2644437127,YEWNWGDNALNTGKQVDQTVSK,21,266,287
91,2645861674,YEWNWGTNALGTGKQVDQTVSK,21,269,290
92,2649292179,YEWNWGTNALATGKQVDQSVSK,21,261,282
93,2654354322,YEWNMGSTRSDLSDEEQTISD,20,240,260
94,2654356166,YEWAMGQYAGTGTRAEGTWTSSLSQ,24,254,278
95,2661929472,YEWNMGQYSNSGTRKQGTWTKALSN,24,255,279
96,2663801603,YEWNMGQYSNSGTRKSGTWTKALSN,24,250,274
97,2676252688,YEWNWGANDLSTGKQVDQTVSK,21,265,286
98,2685198825,YEWNWGTNALSTGKQVDRTVAK,21,275,296
99,2685210361,YEWNWGTNALSTGKQADQTVSK,21,269,290
100,2697184229,YEWNMGQYATTGTRKSGTWTKALSN,24,254,278
101,2702467603,YEWCWGGNALSSGEQADRTVSK,21,264,285
102,2723987974,YEWNLGVTRTGLSEDMQALSD,20,231,251
103,2725337609,YEWMMGQFSTAGNRADGTWTASLSQ,24,254,278
104,2731590348,YEWNWGTNVTQSTGKVVDQSVSK,22,254,276
105,2731610882,YEWNWGTNVTQSTGKVVDQSVSK,22,254,276
106,2733488751,YEWNMGQYSNSGTRKQGTWTKALSN,24,255,279
107,2743529465,YEWNMGQYSNSGTRKSGTWTKALSN,24,250,274
108,2745152095,YEWNMGQYSNSGTRKQGTWTKALSN,24,255,279
109,2745546911,YEWNMGQYSNSGTRKQGTWTKALSN,24,255,279
110,2755298023,YEWNMGQYARSSDSFTGALSS,20,234,254
111,2766268657,YEWNWGANDLSTGKQVDQTVSK,21,266,287
112,2767881435,YEWNWGANDLSTGKTVDQTVSK,21,269,290
113,2768039407,YEWNWGTNVTQSTGKVVDQTVSK,22,254,276
114,2768110288,YEWNWGTNDLSTGKQVDQTVSK,21,265,286
115,2771870499,YEWNMGQYITAGTRADSTWTSALSD,24,270,294
116,2772467531,YEWNWGANKLSTGKQVDQTVSK,21,262,283
117,2773978781,YEWNWGTNVTQSTGKVVDQSVSK,22,254,276
118,2774734325,YEWNMGQYSNSGTCKQGTWTKALSN,24,255,279
119,2777182996,YEWNWGTNTLAGGKQVDQAVSK,21,258,279
120,2785369462,YEWNWGGNALSTGKQVDQTVSK,21,262,283
121,2786651172,YEWNWGTNDLSTGAQVDQSVSK,21,258,279
122,2786670570,YEWNWGTNVTASTGKTVDQTVSK,22,260,282
123,2786684491,YEWNWGSNDLSTGKQVDQTVSK,21,268,289
124,2790741903,YEWGSGQYASDGTRAEGTWTRALSQ,24,245,269
125,2794159888,YEWNWGTNDLATGKQVDQSVSK,21,257,278
126,2798895369,YEWNWGTNALATGKQVDQSVSK,21,261,282
127,2798901129,YEWNWGSNATSSGSQVDQTVSK,21,257,278
128,2798936322,YEWNWGTNALRTGEVVDQTVSK,21,268,289
129,2800247947,YEWMLGTTRTGLSDEEQSISD,20,232,252
130,2800257106,YEWMMGVTRTDLSDEEQSISD,20,239,259
131,2800264098,YEWMLGTTRNDLSEEEQAISD,20,254,274
132,2800272269,YEWMMGSTRSGLSDEEQSISD,20,236,256
133,2800635855,YEWNMGSTRSGLSDEEQEISD,20,256,276
134,2800691517,YEWNMGSTRSGLSDEEQEISD,20,265,285
135,2800698379,YEWNMGSTRSGLSDEEQEISD,20,256,276
136,2800734521,YEWQMGNTRTSLSDEELTLSN,20,265,285
137,2800836454,YEWQMGQYSTDGTRADGQWTQLLSR,24,249,273
138,2805031640,YEWNWGSNATGSGSTVDQTVSK,21,256,277
139,2805387677,YEWNMGQYSNSGKRKDNTFTGQLST,24,263,287
140,2805392336,YEWNMGQYSNSGKRKDNTFTGQLST,24,263,287
141,2805394774,YEWNMGQYSNSGKRKDNTFTGQLST,24,263,287
142,2805467496,YEWNMGQYSNSGKRKDNTFTGQLST,24,263,287
143,2805551944,YEWNMGQYSNSGKRKDNTFTGQLST,24,263,287
144,2805601234,YEWNMGQYSNSGKRKDNTFTGQLST,24,263,287
145,2808842023,YEWNWGGNALSTGKQVDQTVSK,21,261,282
146,2808920540,YEWNWGANATQSTGKVVDQSVSK,22,248,270
147,2812824980,YEWNMGQYSNSGTRKQGTWTKALSN,24,255,279
148,2812990800,YEWNMGQYSNSGTRKQGTWTKALSN,24,255,279
149,2813246512,YEWQMGQYTNSNSRKNKTFQKALSN,24,264,288
150,2813283681,YEWQMGQYTNSNSRKNKTFQKALSN,24,264,288
151,2813287926,YEWQMGQYTNSNSRKNKTFQKALSN,24,264,288
152,2826332774,YEWQMGQYGNEGNRKKNSFQKQLST,24,264,288
153,2826335383,YEWQMGQYGNEGNRKKNSFQKQLST,24,264,288
154,2826338038,YEWQMGQYGNEGNRKKNSFQKQLST,24,264,288
155,2826347370,YEWQMGQYGNEGNRKKNSFQKQLST,24,264,288
156,2826355069,YEWQMGQYGNEGNRKKNSFQKQLST,24,264,288
157,2831425956,YEWMMGSTRSGLSDEEQSISD,20,236,256
158,2834105888,YEWMMGQFSTAGNRADGTWTAALSQ,24,252,276
159,2837623044,YEWMMGQFSTAGNRADGTWTAALSQ,24,252,276
160,2840801686,YEWGAGQYASADTRAEGTWTRALSQ,24,246,270
161,2846498488,YEWMMGQFSTAGNRADGTWTAALSQ,24,252,276
162,2846501797,YEWMMGQFSTAGNRADGTWTAALSQ,24,252,276
163,2851424282,YEWNMGQYSNSGTRKQGTWTKALSN,24,255,279
164,2862285611,YEWNWGANATGSGSTVDGTVSK,21,263,284
165,2866956199,YEWMMGQFSTAATRADGTWTAALSQ,24,251,275
166,2867631196,YEWNWGTNELSTGKQVDQAVSK,21,262,283
167,2867663697,YEWNWGTNDLSTGEQVDQTVSK,21,261,282
168,2872781297,YEWNWGTNALSTGKQVDQTVSK,21,266,287
169,2873090557,YEWNWGANATQSTGKVVDQSVSK,22,261,283
170,2882241440,YEWNMGQFATTNTRAEDTWTSALSE,24,276,300
171,2900922251,YEWNMGQYSNSGTRKQGTWTKALSN,24,255,279
172,2907612462,YEWNMGQYSTSRTRASGTFTKALSN,24,255,279
173,2910157584,YEWNMGLTRTNLDSQTQALSD,20,333,353
174,2911594683,YEWGAGQYASADTRAEGTWTRALSQ,24,250,274
175,2916502694,YEWNMGQYSNSGTRKQGTWTKALSN,24,255,279
176,2917284031,YEWNMGSTRSDLSDEEQTISD,20,240,260
177,2925440118,YEWNMGQYSNSGTRKQGTWTKALSN,24,255,279
178,637389931,YEWQFNGINDWHRYQPVAGTTKNGRPKFEPVSGQLTVEEQALSL,43,216,259
179,646037829,YEWQFGGIRDYCRTRHKKTEHGIVRIQEDGTMTDRQMELSG,40,245,285
180,646038830,YEWEFCGFDDYYWGEKSGVMSEEQKKLSA,28,215,243
181,648819057,YEWMFQAKKIYTFNSRVRPQIINKRQQLLSK,30,206,236
182,2518420498,YEWQFDGINDWNRSQPVAGSMKNGRPKFEPITGTLSASDQSLSA,43,216,259
183,2545540001,YEWQFNGINDWNRSQPVAGSMKNGRPKFESITGTLSASDQSLSA,43,216,259
184,2572637226,YEWQFNGINDWHRYQPVAGTAVNGRPQFEPVSGVLDSEAQALSA,43,216,259
185,2580247201,YEWQFNGINDWHRYQPVAGTTKNGRPKFEPVSGQLTVEEQALSL,43,216,259
186,2581305531,YEWQFNGINDWHRYQPVAGTTKNGRPKFEPVSGQLTVEEQALSL,43,216,259
187,2596287002,YEWMFQAKKIYTFNSRVRPQIINKRQQLLSK,30,206,236
188,2597909647,YEWQFNGINDWNRSQPVAGSMKNGRPKFESITGTLSATDQSLSA,43,216,259
189,2599312445,YEWMFQAKKIYTFNSRVRPQIINKRQQLLSQ,30,206,236
190,2608465151,YEWMFQAKKIYTFNSRVRPQIINKRQQLLSQ,30,206,236
191,2608983103,YEWMFQAKKIYTFNSRVRPQIINKRQQLLSQ,30,206,236
192,2612392617,YEWQFNGINDWHRYQPVAGTAVNGRPKFEPVSGVLDSEAQALSA,43,216,259
193,2621025926,YEWMFQAKKIYTFNSRVRPQIINKRQQLLSQ,30,206,236
194,2621080637,YEWEFCGINDYHKMKFERIEGSPKPKLVPISGEMNELQIELSK,42,217,259
195,2641120372,YEWQFNGINDWNRSQPVAGSMKNGRPKFESITGTLSANDQSLSA,43,216,259
196,2642101342,YEWQFNGINDWHRYQPVAGTTKNGRPKFEPVSGQLTVEEQALSL,43,216,259
197,2649694916,YEWQFNGINDWHRYQPVAGTTKNGRPKFEPVSGQLTVEEQALSL,43,216,259
198,2656988094,YEWEFCGINEYHTMKFGYPESGEDKPEITSVDVCMTDVQKQMSA,43,216,259
199,2673085225,YEWQFNGINDWHRYQPVAGTTKNGRPKFEPVSGQLTVEEQALSL,43,216,259
200,2734583469,YEWNMGQYSNSGTRKSGTWTKALSN,24,218,242
201,2745503175,YEWQFNGINDWHRYQPVAGTTKNGRPKFEPVSGQLTVEEQALSL,43,216,259
202,2771784190,YEWEFGGLSDYHWGDREGVMTEAQNMLSV,28,215,243
203,2777374232,YEWNWGANDLSTGKPVDQTVSK,21,284,305
204,2790456210,YEWEFHTLLEYHMVTFLPPRDGEKEPRKLNKDGLLTAHQQTLSA,43,215,258
205,2791281950,YEWEFCGRNHWSGRIGEGDLSEEQIRLSD,28,209,237
206,2793572515,YEWEFCGINDYHKMKFERIEESRKPKLVPISREMNELQIELSK,42,217,259
207,2800727165,YEWNMGSTRSGLSDEEQEISD,20,138,158
208,2808082563,YEWEFCGLNDYSKKIEIPPQEGETDATFIVDEGTMTEAQQKMAE,43,215,258
209,2808295654,YEWEFCGLNDYSKKIEIPPQEGETDPTFIVDEGMMTEAQQKMAE,43,215,258
210,2810452938,YEWQFHNVNDYRRMSMRLEGGRPSFTPEDGTMTDDQIRISQ,40,214,254
211,2812825829,YEWQFNGINDWNRSQPVAGSMKNGRPKFESITGTLSASDQSLSA,43,216,259
212,2812989787,YEWQFDGINDWNRSQPVAGSMKNGRPKFEPITGTLSANDQSLSA,43,216,259
213,2815614087,YEWQFGDIRDYCRTRHKKTEHGIVRIQEDGTMTDRQMELSG,40,245,285
214,2832934002,YEWLFHGLNDYKKKKIERVNGEIIKTPIKGTMSADQIALSA,40,216,256
215,2835246207,YEWEFCGLNDYSKKIEIPPQEGETDPTFIVDEGTMTEAQQKMAE,43,215,258
216,2842958932,YEWEFCGFDDYYWGEKSGVMSEEQKKLSA,28,215,243
217,2844122133,YEWLFRKESVFHMMKFEMSPKGPKMIPVVGELSEEQKKLSA,40,231,271
218,2854057680,YEWEFCGLNDYSKKIEIPPQEGETDPTFIVDEGTMTEAQQKMAE,43,215,258
219,2882850827,YEWEFCGLNEFSKKIEIPPQEGESNPTFIVDEGTMTEEQQKMAE,43,216,259
220,2885675413,YEWQFNGLNTWHSQQFTRVGDRMQVTPVAGKLTAKEQALSA,40,214,254
221,2915416054,YEWLFQKESVFHMMKFEMSPEGPKMIPVAGELDEEQRKLSK,40,234,274
222,2917284871,YEWMFQVKKIYTFNSRVRPQIINKRQQLLSQ,30,206,236
223,2923823150,YEWEFCGLNDYSKKIEIPPQEGETDPTFIVDEGTMTEAQQKMAE,43,215,258
224,2925425477,YEWQFNGINDWHRYQPVAGTTKNGRPKFEPVSGQLTVEEQALSL,43,216,259
225,2925436013,YEWQFNGINDWHRYQPVAGTTKNGRPKFEPVSGQLTVEEQALSL,43,216,259
226,2925440967,YEWQFDGINDWNRSQPVAGSMKNGRPKFEPITGTLSASDQSLSA,43,216,259
227,4j0h_A,YEWQFNGINDWHRYQPVAGTTKNGRPKFEPVSGQLTVEEQALSL,43,217,260
228,6yq4_A,YEWMYNGVNSYSRMEFTRNTSAQEYNDRSLTRSTVQGNLTNDEINISN,47,219,266
229,7q6y_A,YEWQFCGYNDYHRIKHVRSESGVKNIQIDGILTEKQIKISE,40,228,268
